NO textures/no.xpm
SO textures/so.xpm
WE textures/we.xpm
EA textures/ea.xpm

F 220,100,0
C 0,100,220

    111111111
    100000001
111 10E00001
100 10000001
111111111111
