NO tex/no.xpm
SO tex/so.xpm
WE tex/we.xpm
EA tex/ea.xpm

F 50,50,50
C 150,150,150

111111111111111
100000000000001
100011111110001
100010000010001
1000100S0010001
100010000010001
100011111110001
100000000000001
111111111111111
