NO n.xpm
SO s.xpm
WE w.xpm
EA e.xpm

F 0,255,0
C 0,0,255

111111111
100000001
101111101
10W000001
101111101
100000001
111111111
