NO a.xpm
SO b.xpm
WE c.xpm
EA d.xpm

F 255,0,0
C 0,255,0

111111
10N001
1000 1
111011
